2,,,,,,,
N,N,X,X,X,X,N,N
N,N,N,X,X,X,N,E3
N,N,N,X,X,X,N,P1
N,N,N,N,N,X,X,N
N,X,X,N,N,N,X,N
N,X,X,N,N,N,N,N
N,X,X,X,X,N,N,N
N,N,N,N,N,N,N,N
N,N,E3,P2,N,N,N,N
N,N,N,N,N,N,N,N
