2,,,,,,,
N,N,X,X,X,X,N,N
N,N,P1,X,X,X,N,N
N,N,N,X,X,X,N,N
N,N,P2,E1,P3,X,X,N
N,X,X,N,N,N,X,N
N,X,X,N,N,N,N,N
N,X,X,X,X,N,N,N
N,N,N,N,N,N,N,N
N,N,N,N,N,N,N,N
N,N,N,N,N,N,N,N
