2,,,,,,,
N,N,X,X,X,X,N,P4
N,N,N,X,X,X,P1,N
N,N,N,X,X,X,N,E2
N,N,N,N,N,X,X,E1
N,X,X,N,N,N,X,E2
N,X,X,N,N,N,P2,N
N,X,X,X,X,N,N,P3
N,N,N,N,N,N,N,N
N,N,N,N,N,N,N,N
N,N,N,N,N,N,N,N
