2,,,,,,,
N,N,X,X,X,X,N,N
N,N,N,X,X,X,N,N
N,N,N,X,X,X,N,N
N,N,N,N,N,X,X,N
N,X,X,N,N,N,X,N
N,X,X,N,N,N,N,N
N,X,X,X,X,N,N,N
N,N,N,E3,N,N,N,P3
N,N,N,E3,N,N,N,P4
N,N,N,N,N,N,N,N
