2,,,,,,,
X,X,X,X,X,X,X,X
N,N,N,N,N,N,X,X
N,N,N,N,N,N,N,N
N,N,N,N,N,N,N,X
N,N,N,N,N,N,N,N
N,N,N,N,N,N,N,N
N,N,N,N,N,N,N,N
N,N,N,N,N,N,X,X
N,N,N,P4,X,X,X,X
P3,P2,P1,N,E2,E4,E3,X
