5,,,,,,,
X,X,N,N,N,X,N,N
X,X,N,N,N,X,N,N
X,X,N,N,N,X,X,N
X,X,P3,N,P1,N,X,N
X,X,N,E2,N,E3,N,N
X,X,X,X,N,N,N,N
X,X,X,X,X,N,N,N
X,X,X,N,N,N,N,N
N,N,N,N,N,N,N,N
N,N,N,N,N,N,N,N
