2,,,,,,,
X,X,N,N,N,X,N,N
X,X,N,N,N,X,N,N
X,X,N,N,N,X,X,N
X,X,N,N,N,N,X,N
X,X,N,N,N,N,P2,N
X,X,X,X,N,N,N,N
X,X,X,X,X,E1,N,N
X,X,X,N,N,N,N,N
N,N,N,N,N,N,P1,N
N,N,N,N,N,N,N,N
