2,,,,,,,
X,X,N,N,N,X,N,N
X,X,N,N,N,X,N,N
X,X,N,N,N,X,X,N
X,X,N,N,N,N,X,N
X,X,N,N,N,N,N,N
X,X,X,X,N,N,N,N
X,X,X,X,N,E1,N,N
X,X,X,N,N,N,N,N
N,N,N,N,P1,N,P2,N
N,N,N,N,N,N,N,N
